000000000000000000000000000000
000000000000000000000000000000
000000000000000000000000000000
000000000000000000000000000000
000000000000000000000000000000
000000000000000000000000000000
000000000000000000000000000000
000000000000000000000500000000
000000000000000000005450000000
000000000050000000055455000000
000000000545000000300400000000
000000005545500003333333000000
333330000040003333222222330000
222223333333332222222222223333
222222222222222222222222222222
222222222222222222222222222222
222222222222222222222222222222
222222222222222222222222222222
222222222222222222222222222222
111111111111111111111111111111